wwwwwwwwwwwwwwwwwwwwwwwwwwww
ww++++wgw+++++++++++++++++ww
w000000==0000000000====0033w
w0000000==000===0000000===1w
ww++++++++++++++++++++++++ww
w..._ll_......_..___....._.w
w000000==00000=000000000==3w
w0====000000===00000000===1w
w000000000=000000====0000=1w
ww+++++++++++++++A++++++++ww
wwwwwwwwwwwwwwwwwwwwwwwwwwww
